41
41
2
2
38
38
0
3
1
00000100000100000100000100000100000100000
00000100000100000100000100000100000100000
00000000000100000000000000000000000000000
00000100000100000100000100000100000100000
00000100000100000100000100000100000100000
11011111011111011111111111111111011111111
00000100000100000100000100000100000100000
00000100000100000100000100000100000100000
00000100000000000100000000000000000000000
00000100000100000100000100000100000100000
00000100000100000100000100000100000100000
11011111111111011111111111111111111111011
00000100000100000100000100000100000100000
00000100000100000100000100000100000100000
00000000000000000100000000000000000000000
00000100000100000100000100000100000100000
00000100000100000100000100000100000100000
11011111011111011111011111111111111111111
00000100000100000100000100000100000100000
00000100000100000100000100000100000100000
00000000000100000100000000000100000000000
00000100000100000100000100000100000100000
00000100000100000100000100000100000100000
11011111011111011111111111011111011111011
00000100000100000100000100000100000100000
00000100000100000100000100000100000100000
00000000000100000000000100000000000100000
00000100000100000100000100000100000100000
00000100000100000100000100000100000100000
11011111011111011111111111111111011111011
00000100000100000100000100000100000100000
00000100000100000100000100000100000100000
00000000000000000000000000000100000100000
00000100000100000100000100000100000100000
00000100000100000100000100000100000100000
11111111111111111111111111111111011111011
00000100000100000100000100000100000100000
00000100000100000100000100000100000100000
00000000000000000000000100000000000000000
00000100000100000100000100000100000100000
00000100000100000100000100000100000100000
