30
30
1
1
28
28
0
5
0
111111111111111111111111111111
100000000100000000000001000001
111111110101111111111101010111
100000000101000100010101010101
101111111101010101010101010101
100000000101010101010101010101
111111110100010001000100010101
100100010111111011111111110101
100001010100000000000110000101
101111110000111111100011111101
101000011001001111111001000001
101011001010111111111101111101
101011100011111111111101000001
101001110011111111111101011111
101101110001111111111101010001
100100110110111111111000010101
110110001001111111111101011101
100011010011111111111101000001
101001000011111111111101011111
101101111011111111111101000001
101000001001111111111001111101
101011101100111111100011000001
101000100110000000001110011111
101110110011111011111011000001
101000011000001001000000010101
101011111111111101111111111101
101000000000000000000000000001
101111111111111111111111111101
100000000000000000000000000101
111111111111111111111111111111
