31
21
0
19
30
19
1
10
0
010100000000000000001
101101111111111111121
010100000000000000121
101111111111111110121
010100000000000000121
101101111111111111121
010100000000000000121
101111111111111110121
010100000000000000121
101101111111111111121
010100000000000000121
101111111111111110121
010100000000000000121
101101111111111111121
010100000000000000121
101111111111111110121
010100000000000000121
101101111111111111121
010100000000000000121
101111111111111110121
010100000000000000121
101101111111111111121
010100000000000000121
101111111111111110121
010100000000000000121
101101111111111111121
010100000000000000121
101111111111111110121
010100000000000000121
101101111111111111121
010100000000000000001
