30
30
28
0
29
29
0
5
0
000100010001000001000000010000
010101111101010101010111010111
000001000100010101010000010001
010111010111010101010101010101
000001010100000001000100010100
111101011111110111011101111101
000000000100000101010101000001
110111011101010101010101110101
000000010001010001000001010101
011111110111011101110111010101
010000010000000000010000010100
011101110111010101111111010101
000000000100010100000100000100
011111110101111111111111111101
010000010100000000010000010001
010111011101010111010111110111
010100000001010001010000000100
110101110101010111111101111101
000000010100010000010100000000
011111011111110101110101111111
000100000001000001000000010000
010111010101010101011101011111
000100010101010000000101010101
011101111101110111111111110101
000001000001000100010001000101
010111010101010101110111010111
000001000100010000000000000001
110111011101110101110111011101
000001010000010101000100000100
111111111101110101011111111100
